#################################################
#     #       #             #             #     #
#                           #       # ### ##### #
#                       #         # # #         #
#         # # #   #     #                     # #
#                 #     # #   #   #   #     # # #
# ###       ### ### ### # #           # ### # # #
# #   # #     #   #   #         #     #     #   #
#       # #       ### ### #   # # ### ### ##### #
#                         #   #   # #   #       #
# #   # # ###                   ### ### ###   ###
# #     # # #           #               #       #
# #     # # #       ##### ### #         ### #####
#       #         #   #   #   #     #       #   #
# #########     ###   # ###   #                 #
# #     #         #   #   #   #                 #
# #     #    ##         #               ##### ###
#           #           #                       #
#################################################