#################################################
#     #       #             #             #     #
#       #                   #       # ### ##### #
#       #               #         # # #         #
#       #         #     #                     # #
#                 #     # #   #   #   #     # # #
# ###       ### ### ### # #           # ### # # #
# #   # #     #   #   #         #     #     #   #
#       # #       ### ### #   # # ### ### ##### #
#                         #   #   # #   #       #
# #   # # ###                   ### ### ###   ###
# #     # # #           #               #       #
# #     # # #           # ###           ### #####
#       #         #   #   #   #     #       #   #
# #########     ###   # ###   #                 #
# #     #         #   #   #   #   #             #
# #     #    ##         #         #     ##### ###
#           #           #                       #
#################################################